Derelict
A dark mystery by Vern & Mark
Release 1 / Serial number 150531 / Inform 7 build 6L38 (I6/v6.33 lib 6/12N) SD

Captain's Quarters
The Captain's Quarters is a room of luxury.  Even though the Captain doesn't actually get to spend much time here, it is Federation standard that their quarters are a place they can retreat to for relaxation and decompression.  But not explosive decompression.  That would be bad.  The doorway to the Commons is fore of here.

>s
Which do you mean, the south or starboard?

* * *

>aft
You can't go that way.

>fore
Commons
The Dining Commons is a typical cafeteria, with a small recreation area attached.  The projector in the rec area is attached to a holodisk player, with a small selection of physical disks, as well as a hard drive containing a much wider selection of programming, though most of that has been censored by the military.  The passengers and crew tend to enjoy their personal copies of "It Came From Planet 10 in the Outer Rim" more than the digital "__ Came From _____ in the ______."  The Captains Quarters is aft of here, and Communications is fore.

>f
Communications
The Communications room is fairly self explanatory, but if you really need a detailed description... there are devices here for communicating.  Most of the technology is nothing complicated, RADAR, X-RAY, infrared sensors, as well as an array of ultra long range radios.  The Commons is aft of here, and the Bridge is fore.

>a
You can't go that way.

* * *

>x room
You can't see any such thing.

>look
Communications
The Communications room is fairly self explanatory, but if you really need a detailed description... there are devices here for communicating.  Most of the technology is nothing complicated, RADAR, X-RAY, infrared sensors, as well as an array of ultra long range radios.  The Commons is aft of here, and the Bridge is fore.

>starboard
Commons
The Dining Commons is a typical cafeteria, with a small recreation area attached.  The projector in the rec area is attached to a holodisk player, with a small selection of physical disks, as well as a hard drive containing a much wider selection of programming, though most of that has been censored by the military.  The passengers and crew tend to enjoy their personal copies of "It Came From Planet 10 in the Outer Rim" more than the digital "__ Came From _____ in the ______."  The Captains Quarters is aft of here, and Communications is fore.